11111111111111
1X0100000000C1
10000111C1C001
100011E0CC00P1
11111100001111
11111111110111