1111111111111111111111111111111111
1P000000000000000000000000000000E1
1001000100000000110000000000000001
1001000100000000101000000000000001
1001000100000000101000000000000001
100111110011110011011100000C000001
1001000100100100100101010000000001
1001000100111100100111100000000001
1X00000000000000000000000000000001
1111111111111111111111111111111111